XXXXXXXXXXXXXXXXXXXXXXXXXXXXXXX
X              P              X
X X XXXXXXXX XXXXX XXXXXXXX X X
XU  XBBBBBBX XBBBX XBBBBBBX  UX
XXX XBXXXXBX XXBXX XXXXXXBX XXX
BBX XBXBBXBX  XBXS   BGGXBX XBB
XXX XBXXXXBX  XBX  XXXXXXBX XXX
___ XBBBBBBX  XBX  XBBBBBBX ___
XXX XBXXXXBX  XBX  XBXXXXXX XXX
BBX XBXTTXBX SXBX  XBXGGB   XBB
XXX XBX  XBX XXBXX XBXXXXXX XXX
XU  XBX  XBX XBBBX XBBBBBBX  UX
X X XXX  XXX XXXXX XXXXXXXX X X
X X          __P__          X X
X XX  XXX  XXXXXXXXX  XXX  XX X
X       X             X       X
XXXXXXXXXXXXXXXXXXXXXXXXXXXXXXX
