XXXXXXXXXXXXXXXXXXXX
XU   X        X   UX
X XX X XXXXXX X XX X
X XP            PX X
X X XX XX  XX XX X X
X      XGGGGX      X
X X XX XXXXXX XX X X
X XP            PX X
X XX X XXXXXX X XX X
XU   X        X   UX
XXXXXXXXXXXXXXXXXXXX